11111
1P011
11C11
110E1
11111
