1111111111
10P01100E1
1011100111
10C0000001
1C10011011
111E0C1001
1111111111
