11111111111111111111
10P011000000000000E1
10111001111000111001
10C00000111110C01101
1C100110000000000011
111E0C10000000000001
11000100101000011011
10011110001011111011
10110C110110100C1001
10000C000C0010000011
11111111111111111111
