111111111111111111111111111111111111111111111111111111111111111
1P0000000000000000000000000000000000000000000000000000000000C11
111111111111111111111111111111111111111111111111111111111110111
111111111111111111111111111111111111111111111111111111111110111
11111111111111111111111111111111111111111111111111111111111E111
111111111111111111111111111111111111111111111111111111111111111
111111111111111111111111111111111111111111111111111111111111111
